NO ./textures/north.xpm
SO ./textures/south.xpm
WE ./textures/west.xpm
EA ./textures/east.xpm
DO ./textures/door.xpm

F 100,160,80
C 30,30,120

11111111111111111
1000000000000D001
10111111110111101
100000N000001D001
10111111110111101
1000000000000D001
11111111111111111